***********************************
*  *                              *
*  **********    ***********      *
*  *        *    *              ***
*           *    *       *        *
* *******   *    ****    *        *
*   *            *       *******  *
*   *     ********       *        *
*   *   *        *   *   *        *
*   *   *      * *   *            *
*       *      *     *            *
*   *  *********     ********     *
*   *                *            *
***********************************